   #######
 #      ##
 # ### # #
 # #   # #
## ### # #
## #
   ######
 #
 ###### ##
         X