 ####################################################################################################
      # #         # #       #   #   #       #   # #   #     #     # #   #     # # #   #     #       #
# ##### # ##### ### ### # ##### # ##### ### # ### # ### # # # # ### # ####### # # # # # ### ####### #
# #   #   #     # #   # # #   # # #   #   #   #   #     # #   # #   #   #       #   #   #     # # # #
# ### ### ##### # # ##### # ### # # ##### ### # ####### # # ##### ##### # ####### # ##### # ### # # #
#       #     # #   #   # #     #     #     #     #     # #       #         # #   #   #   # # # # # #
# ##### # # ##### ### ### # ######### ### # ### # ########### # ##### ### ### ####### # # ### # # # #
# # # # # #   #   # # # #     #     #     # #   # #       #   # #   #   #   # #   #   # #     #   # #
# # # # # ####### # # # # ######### # ### # ### # ### # # # # ##### ### # ### ### # ####### ### ### #
#     #                 #   #   # #     # #   # #     # # # # #         # #   #   # # # #           #
# # ##### ### # # ####### # ### # ####### ##### ####### ##### ### ######### ##### ### # ### ##### ###
# #     # #   # # #     # # #   #       # #     #   #     # #           #           #     #     #   #
# ##### ### ### ### ##### ### # ### ### # ##### # # ### # # ### # # # ######### ### # ### ### ### # #
# #   # #   # #     #     #   # # #   # # #   # # # #   # #     # # # #     #     #   # #   #   # # #
### ##### ### # ####### ### ##### # # ##### ##### # ### ### ######### ##### ### # ##### # # # ### # #
#   # #   # # # #     # #           #   #     #   #       #   # # #     #     # # #       #   # # # #
# # # # # # # ### ##### # # ######### # # ########### ##### ### # ######### # # ##### # ### ### ### #
# #   # #     # #   #   # # #   # #   # # # #   # #     #           # # #   #       # # #   #   # # #
# # ####### ### # ### # ### # # # # ##### # ### # # # ####### # ##### # ##### # ######### ### ### # #
# #     # #     #     # # # # # # # #       #     # #     #   # #       # #   # #     #     # # #   #
##### ### # # ### # # ### # ### # # # ### ### ######### ##### ##### ##### ### ####### ##### # # # # #
# # # # #   # # # # #     #   # #   #   # #         # # #     # #   # #           # #   # #     # # #
# # # # ##### # # # # ##### # # # ### ##### ### ##### # ##### # ### # ####### ##### # ### ####### # #
#     # # # #     # # #     # #         # # #   #     #       #       # #   # #   # #     # #   # # #
# ##### # # # ### ####### ######### # ### # # # # ### # ####### ### ### ### # ### # ### # # # # ### #
# #   #         # #     #   #     # # #     # # # #     # # # #   #                     # # # #   # #
# # ####### ####### ##### # # # # # # ### ### ##### # # # # # # ##### ####### # ### ### ### # ### ###
#           #     #   # # # # # #   # # # #     #   # #             # #       #   # # #         #   #
### ### # ##### # # ### # ####### ### # ### ### # # ### ### ##### # # ##### ######### # # ##### # ###
#   #   # #     # #   # # #       #   #   #   #   # # #   #   #   # # # # # # # #       # # #   #   #
# ##### # # ### # # ### ### ### # ##### ### ####### # ####### ######### # ### # # ######### # ### ###
#     # # #   # # # # # # # #   # #     # # #     # # #   # # # #   #                     #     # # #
# ####### ####### # # # # # ########### # ### ####### ### # ### # ### ######### ### ############### #
#   #   #   #       #   # #     # #     #     #   #   #   # #   #         #       #         #       #
# ##### # # ##### # # ### ### # # # ##### ### # # ### ### # # ### # ########### # ##### # # # # # # #
#   #     # # #   # #       # # #   # # #   #   #           #     # #     #   # # #   # # #   # # # #
### ##### ### ### ### # # ##### ### # # ##### ####### # # # ##### # # # ### ##### ### ### ##### #####
# # #       #         # # #     #         #     # # # # # # #     #   #     #       #       # #   # #
# ### # ############# ######### # ####### # ##### # # ### # # # # ### ##### # ### ########### ##### #
#   # # #     # #     #       #     #       #         #   #   # # #     # # # #         #     #     #
### ### # ##### # ### # ### ##### ##### # ####### # ################# # # ####### # ### ### ### # ###
# #     #   # # # #     #           #   #   # # # #       # #     # # # #     # # # #   #       #   #
# # # ##### # # ### ######### ### # ##### # # # ### ### # # ### ### ### # # # # # # # # ##### ##### #
#   #   #   #         #       #   # #     #     # # #   #   #     #     # # #     # # #   # #   #   #
# # ### ### ### # # ### ##### ### # # ##### # ### ##### ### # # ### ### ##### ####### ##### # #######
# # #       # # # # #     # # # # # # #   # #   #       #     #   # #   #           # #     #   #   #
# ### ### # # ##### ##### # ### ### ### ##### # ####### # ############# # # # ### ### # ### # ##### #
#   # #   # # #     #   #     #   #     #     # #   # # # #   # #       # # # # # #   # #   # # #   #
### # # ### # ####### ### ####### ### ########### ### ### ### # ### ######### # ##### ### ### # # # #
# # # # #     #     #     # # #     # #   #   #   #             #     #   #     #       # #   #   # #
# ####### ### # ##### # ### # ### ### # # # ### ### ######### ####### # ######### # ### # ### ### ###
#     #     #   #     # #   #   # #     #   # # # # #       #     # #       #   # #   # #     #     #
# # # ### # # ######### ### # # # # ### ##### # # ### ### ### # ### # # ### # ### # # # ### ####### #
# # # #   # #           #     #       #   # # #     #   #     # # # # # #       # # # #   #     # # #
# ##### # # # ##### # ### # ############### # ##### ####### ##### # ##### ##### ##### ####### ### # #
#     # # # #     # # #   # #     #     # # #     # #   #   # #     # # # # #   # #             #   #
### ##### ##### ##### ########### ### ### # ### # # ### # # # # # ### # ### # ### # # ##### ### # # #
#       #     # #     #     #   #       #       #     #   #   # # #     #         # #     # #   # # #
### ##### ### ############# ### ### ### # ####### ######### ##### # ### ####### ### # # # # # # # ###
# #         # #     # # #       #   #   # #   #         #           #   # #   # #   # # # # # #     #
# ### ##### ### # ### # ### ### # ### ####### # # # ##### # ##### ####### # # ### ### # ##### #######
#   #   # #     # #   # #     # #   # #       # # #     # # #   #   #   #   # #   #   #   #         #
# ### ### ### ##### ### ##### ### ##### # ### ####### ##### ### # ### ##### ######### ############# #
#         # #   #     # #   #   #       # #       #   # # #   #   # #   # #   #     #   #     #     #
# # ### ### ##### ##### # # # ### ####### ##### # ### # # ####### # # ### # ##### ### # # # # # ### #
# # #           # #   #   #   #         # # #   #   #             #   #       # #   # # # # #   #   #
# ### ### # ### # # # ##### ############### # # ######### ### # # # ### # ##### ### ### ##### ##### #
#   #   # #   # #   # # #       # # #   #   # # #   #       # # # #     #   #     #       # # # #   #
##### # ### # ##### ### # ### ### # # ### ### ### ##### ####### ### ##### ### # # ##### ### # # #####
#     # #   # # #     #   # #       #             # #     #           # #     # # #       #         #
# ### ##### ### ##### ### # ### ##### ### ##### ### # # ### # ### # ### ### ########### ##### # ### #
#   # #   # #           #   #       # #   #     # #   # # # # #   # #     # # # # # # #   #   #   # #
####### ####### ####### # ############# ######### ##### # ##### ##### ##### # # # # # # # # ####### #
# #   #       #     #         #         #                 #   #         #   #   # #     # #     # # #
# # ##### # ########### # # # ##### # # ### ########### # # # ##### ##### ### ### ##### ##### ### # #
#         # #   # # # # # # # #   # # #             #   #   # # #   #     # #     #   # # #   # #   #
##### # # ### ### # # ##### ### ####### ### ######### ##### ### ########### # ### ### ### ##### ### #
#     # #             #   #         #   #   # # #   #   #       #     #         #       #           #
##### # ### ### ### # ### # ######### ##### # # # ######### ##### ### ##### ######### # ######### # #
#     #   # # #   # #     #       # #     # #         # #     #     # #   # #   #     # # #     # # #
# ### # ### # ######### # # ### # # ####### # ### ### # # ### ##### ##### ### # # # ### # ##### ### #
# #   #   # #     #   # #   # # # #   #   # # # #   # #   # # #     #     #   # # #   #     # #     #
### # # # ### # # ### ### ### # # ### ### ### # ##### ### # ### # ##### ### ##### # # ####### # #####
# # # # # # # # # # #   # #     # #     #   # #     # #   #   # #   #   #     # # # #       #   #   #
# # # ### # # ##### ### ##### # ##### # # # # ##### # ### ### ### ### # ##### # ##### ### # ### ### #
#   # #     #     #         # # # # # #   # # #     # #   #     #   # #       # #   #   # #       # #
### ######### ##### ####### ### # # # ##### ### # ### ### # ##### ##### ### ### # ##### ####### ### #
# #   #   #           # #           #     #     # #       # #   #     #   # #           #     #     #
# ##### ### ### # # ### ##### # # ##### # ### ### # ### ### ### ##### # # ####### ### ### ### #######
# #       #   # # # #       # # #   # # #   # # #     #   # # #     # # # #   # # # # # # #   # # # #
# ####### # ### ##### ### ####### # # # ##### # ##### ### # # # # # # ### # # # ### # # ##### # # # #
#     #     # # #       # #       #   # #       #   #   # #     # #       # #   #   # #     #     # #
### ### # ### # ### ######### ##### ##### ######### ##### ### # ##### ##### # ### ##### ### ### ### #
#     # #     # #     # #   # #         # # #         #     # # #   #   #   #   #       #   #     # #
### ##### ### # # ### # # ### # ### ##### # # ############# ### # # ### # # ### ##### # # # # ##### #
# #     # # # # #   #       # # # #     #   #           #         # #     #   # #   # # # #         #
# ##### # # # ######### # # ### # # ### ### ##### ### # # ### ############### ### ### ########### # #
#   # # # # # # # # # # # # # #   # # #   # # #     # #     # #       #   #   #   #           #   # #
# # # # # # ### # # # # ##### # # ### # # ### ####### ### ######### ##### ### # # ##### # # ####### #
# #     # #                   # # #     # # # # # # # # # #     # # # #         # # #   # #   #     #
# # ### ### # ##### ##################### # # # # # ### # # ##### # # ##### # # # # # ########### # #
# #   #   # # #       # #   # # #   #     #       #   #   #       #         # # #     # # # # #   # #
####### ######### # ### # # # # ### # # ####### ### ##### ### ### ##### ########### ### # # # # #####
#   #       #     # # # # # #     #   #       #     # #   #   # # # #   # # # # # #     #     #     #
### ### # # # # # # # # # ### ########### ### ### # # ### ### # ### ##### # # # # # ######### ### ###
#   #   # #   # # #         # #     #     # #   # #     #   # # # # #   # # #       #     # #       #
# # # ### # ### ### ####### # # ### ### ### # # # # ### # ### # # # # # # # # ### # # # ### # ##### #
# #   # # # #   # #     #   #     # #     #   # # # #     # # #       #       #   # # #         #   #
### ### ### ##### # ######### ##### ### ####### # ##### ### # ####### # # ####### # # # # ### ### # #
# #   #     # #             # #     #         # # # # #   # # #   # # # # #       # # # #   # # # # #
# # ####### # ### ############# ####### ##### ##### # # ### # ### # # ##### ##### ######### ### # # #
#     #   # #   #                 #   #   # #   #   #   #     # #   # # # # # #     # #     # # # # #
### ### ### # ########### ##### ### ##### # # # # # ### # ### # ### ### # ### ####### ### ### # # # #
#   #   #   #         #     #   #     #     # # # #   #     #         # #   # #       #   #     # # #
# # ### # ### ### ####### # ######### # # ### ####### ### ### # ### # # ### # # ### # # # ### #######
# #   #   #     #     #   # # #   #   # # # # # #   #   #   # #   # # #   # # # #   #   #           #
# ### # # # ##### ######### # # # # ##### # # # # # # ### # # # # ####### # # ### ####### ##### ### #
#   # # # # #       #         # #   # #     # #   #   # # # # # #   # #         #   #     # #     # #
# ######### ##### ### # ### ####### # ### ##### # # ### # ##### ### # # # ### ######### ### # ##### #
#   # # # # #         # #     #     #   #     # # #   #   # #   # # #   # #     #     # #   # #     #
# # # # # # ##### ##### # ### # ##### # ##### # ########### ##### # # ######### ### # # # # ####### #
# #   #   # #   # #     #   # #   # # # #   # #     # # # # #       #   #   # # #   # #   # #   #   #
# # ##### ### ##### ######### ### # ### # ### ##### # # # # ### ### ### # ### # # ### # # # # ### # #
# # # # # # #     #   #   #     #           #   # # #   # # #   #     #     #     # #   # # # #   # #
# # # # # # ### ##### # # # ##### ######### # ### # ### # # # ##### ########### ### ### ### # ##### #
# #   # #           #   # # #     #   #     # #       #       #       #   # #   #     # #   # #     #
# ##### # # ##### ### # ########### ### ##### ### ### # ##### # # ##### ### # ### ##### ### # ##### #
#   #   # # #   #     # #     # # #   #   #         #       # # #   # #     # #       #   #   #   # #
# ### # # ##### ####### # ##### # ### # ### # # ################# ### # ##### # # ### # ####### ### #
# #   # #         #     #       # #         # # #   #   #       # #         # # #   # #   #     # # #
# ### # ### ####### ####### ##### ### ##### ### ### ### # ########### # # # # ### # ### # ### ### # #
#     #   #     #           # #   #   # # #   #   #     # #     #     # # # # # # # #   #     # # # #
# ### ##### ####### # ####### # ### ### # # ### ### # # # ### # ####### # # ### ### ##### # # # # ###
# #   #     # # #   # #     #   #     # # #   # #   # #       # #       # # #   # #       # # #   # #
# ##### # ### # # # ### ##### ### ### # # # # ### ####### ### ####### # ### # ### ####### # ### ### #
# # # # # #   #   # #   # #     #   # #   # #   #   #   #   # #       #   #   #       #   # #       #
### # ##### # # # ##### # # ##### ### ### ##### ##### ### # # # ####### # # ### ######### # ### #####
#     #     # # #       #   #     #         #   #         # # # # #   # # # # # #       # # #       #
# # ######### ##### ### # ##### # ### # # ##### # # # ####### # # ### ##### # # # # ##### # ### ### #
# #   #               # # #     #   # # #   # # # # #   #       # # #         # # # #     #     # # #
# # ########### # ##### # ##### # ### ####### # ##### # ### ##### # ### ##### # # ####### ### ### ###
# # #       #   # # #     #   # # #   #     #       # #   # #         #   #             # #   #     #
# ####### ####### # ### # ### # ##### # ##### # # ########### # ####### ######### ### # ######### ###
#             # # #     #         #     #   # # #     #   #   # #   #     #   #     # #   #     #   #
### ######### # ##### ### ########### # # # # ####### ### # ##### ######### ### ######### # # ##### #
#   #   #   #   #       #   # #   # # # # # # # # #       #       #               # #       # #     #
####### # # ### # ########### # ### ### # # ### # # # # ##### ####### # # ##### ### ### # ##### #####
#     #   #     # #     #       #   #     # # #     # #       # # # # # # # # # # # #   # #       # #
# ####### # ### ####### # ### # ### ######### # ### # ##### # # # # ##### # # ### # ##### ####### # #
# #     # # #   #   # #     # #   #   #         # # #     # # #         #       #   #     #   #     #
# # # # # # ##### ### ### # # ##### # # ##### ### ####### # # ##### # ######### ### # ### # ### # ###
#   # #   # #   # # # # # # #     # #     #   #   #     # # # #     # #     #   #     #   #   # #   #
# ##### ####### # # # # ##### # ### ##### ####### # ### ### ##### ####### # ########### # # ### ### #
# # # #   #           #   #   #       #     # # #     # # #     #   #   # #   # # #     #   #   #   #
# # # ##### ######### ### ### # ##### # ### # # ### ### # # ### ### ### # ##### # # ### ### # ##### #
#       #       #   # #     # # #   # # #   #     #   #   # # #   #   # #       #   #   # #       # #
### ### ####### ### # # ######### # # # # ### # # ##### # ### ####### # # ########### ### # # ### ###
# # #         # #     #   # #     #   # #     # # # # # #       #   #   #       #   #   #   #   #   #
# ######### ######### # # # # # ############# ##### # # ######### # ### ### ### # # # # # # ### # # #
# # #   #     #     #   #     #   #   # #   #   #     # # #   # # # # #     #     # # # # # #   # # #
# # ### # # ### ######### ####### # ### # ### ##### ### # # ### # # # ##### # ### # ####### # # # ###
# # # #   #     # # # #       #           #       #           #   #     #   # # # #   #   # # # #   #
# # # ##### ##### # # # # # ##### ########### ### ##### ######### ### ### ### # # ####### ##### #####
#     # #   #   # #   # # # # #           #   #   # # #         #   #   # # #   #         #   #   # #
# ##### ### # ### # ### # # # # # ######### ##### # # # # ####### ### ##### ##### ##### ### ### ### #
#     #       #     #   # # #   #   # # #   # # # #     #           # #         #     #     #   #   #
# ####### # # ### ####### ### ##### # # ### # # # ############### ######### # ### # # ### # # # ### #
#         # #   # #   #   # #     # #       #       #         # #   #       # #   # #   # # # # # # #
### ### # ##### # # # # # # ####### ####### ##### ########### # # ####### ### # # ############# # # #
#     # #   #       # # #       #     # # #     #   #   #   #   #   # # # #   # #   #     #         #
########### ######### # ##### ### # ### # ##### # # ### # ### ### ### # ### ##### ### # ##### ##### #
# #   #         #   # #   #   #   #     # #     # #   # #           # # #         #   #   #   #     #
# # ##### # ##### ### ### ### ### ### ### # ######### # # ####### ### # ##### ######### ### ####### #
#   #   # #     #     #   #   # #   #     #   # #     #     # #   #               #   #   #       # #
# ##### # ##### ##### ### # ### ####### ####### # ### ####### ### # # # # ####### ### ### ### # ### #
# # #   # # # # # #   # # #       # # # # # #     #       # # #   # # # # #     #   #     # # # #   #
# # ### ### # # # ### # ######### # # ### # # ### ##### ### # # ##### ######### ### # # # # # ### ###
#   #         #     #     # #     #       #   #     # # # # # #         #   # #   #   # # #   #     #
# ### ####### ####### ### # ### ######### ### ### ### # # # # # ### ##### ### ### # ### # # # # # ###
#       #     #   #   #         #   #   #   # # # #     #   #     # # #   # #   # # #   #   # # #   #
##### ##### ### ######### # ##### ### ### # # # # # # ### ### ####### ### # # ### ##### # # # ### # #
#       #     #         # # # #     #     # # # # # #         # #     #   #   #         # # # #   # #
# # # ### ### ######### # # # ##### ### ### ### ##### ##### ### # ##### ### ### ### ##### ####### ###
# # #   # # # #   # #     # #     #   #   # #   #     #   #   #     # #   #   # #   # #     # # # # #
# # ####### # # ### # ##### ##### # ### ####### # # ### ##### # # ### # ### ### ##### ##### # # ### #
# #   #       # #   # #           #     #         #         # # # #     #   # #   # #           #   #
##### ##### ### ### # ######### ### # # ##### # # ##### # ##### ### ### ### # # ### # ##### # # # # #
#     #       # #     #       #   # # #     # # #   #   #   # # # # # #         # #     # # # #   # #
##### # ##### # ### # ### ### # # # ####### ### # # ####### # # # ### # ##### ### ####### ### # ### #
# # # # #     #   # #   # # # # # #   #     # # # # # #   # # # # #     #   # #     # #   # # #   # #
# # # # ### ##### # ##### # # ### ### ##### # # ### # # ##### # # ### # # # # ##### # # ### ### #####
#   # #   #             # #   #     #   #     # #     # #     #       #   # #               #   # # #
# ### ### ### # ### ### # ### ############# # # ### # # # ### ### ##### # ####### ### # ##### ### # #
#     #     # # #   #   #   #       #       #   # # # #   #     # #     # #     # #   #     # #     #
# ### ##### # ######### # ##### ### ### ######### # ####### ### # ############# # ####### ### ### # #
#   #   # # #   # #       # #   #   #     #   #     #     # #   #       #   #   #       # #   # # # #
# ### # # # ### # ### ##### # ##### ######### ##### # ### # ######### # # ### ### ######### ### # ###
# # # # # #   # #   #     # #   #   #   #   #           #     #     # # # #   #       # # #   #     #
# # # ### # # ##### # ##### ####### # ### ### ### ### # ########### ##### # ##### ##### # ### # ### #
#   #   #   # #           #           #         # #   #               #                 #       #   X
#####################################################################################################
